Datafile,Total IDs,Tryptics,Semitryptics,% Tryptics,% Semitryptics
210703_LiP_AHA2_1_60_PeptideGroups_annotated,217,119,98,54.84,45.16
210703_LiP_AHA2_1_90_PeptideGroups_annotated,210,123,87,58.57,41.43
210703_LiP_AHA2_2_60_PeptideGroups_annotated,212,156,56,73.58,26.42
210703_LiP_AHA2_2_90_PeptideGroups_annotated,236,162,74,68.64,31.36
210703_LiP_AHA2_3_60_PeptideGroups_annotated,190,70,120,36.84,63.16
210703_LiP_AHA2_3_90_PeptideGroups_annotated,177,65,112,36.72,63.28
210703_LiP_AHA2_4_60_PeptideGroups_annotated,113,42,71,37.17,62.83
210703_LiP_AHA2_4_90_PeptideGroups_annotated,154,43,111,27.92,72.08
210703_LiP_AHA2_5_60_PeptideGroups_annotated,202,84,118,41.58,58.42
210703_LiP_AHA2_5_90_PeptideGroups_annotated,263,96,167,36.50,63.50
210703_LiP_AHA2_6_60_PeptideGroups_annotated,166,59,107,35.54,64.46
210703_LiP_AHA2_6_90_PeptideGroups_annotated,183,61,122,33.33,66.67
